NO ./textures/bluestone.xpm
EA ./textures/colorstone.xpm
WE ./textures/greystone.xpm
SO ./textures/mossystone.xpm

F 25,25,55
C 150,25,25

111111111111111111111111111111111111111111111111111111111111111111111
100000000000000000000000000000000000000000000000000000000000000000001
100000000000111111000000000000000000000000000000000000000000000000001
100000000001000000100000000000000000000000000000000000000000000000001
100000000001000000100000000000000000000000000000000000000000000000001
100000000001111000000100000000000000000000000000000000000000000000001
100000000001N000000000000000000000000000000000000000000000000000000001
100000000001111111000000000000000000000000000000000000000000000000001
100000000000000000000000000000000000000000000000000000000000000000001
100000000000000000000000000000000000000000000000000000000000000000001
100000000000000000000000000000000000000000000000000000000000000000001
100000000000000000000000000000000000000000000000000000000000000000001
111111000000000000000000000000000000000000000000000000000000000000001
100000000000000000000000000000000000000000000000000000000000000000001
100000000000000000000000000000000000000000000000000000000000000000001
111111111111111110000000000000000000000000000000000000000000000000001
100000000000000000000000000000000000000000000000000000000000000000001
111111111111111111111111111111111111111111111111111111111111111111111
