NO ./textures/book.xpm
EA ./textures/colorstone.xpm
WE ./textures/greystone.xpm
SO ./textures/mossystone.xpm

F 25,25,25
C 150,25,25

1111111111111111111
10000000000000000N1
1000000000001000001
1000000000010000001
1000000000000000001
1000000000000000001
1000000000000000001
1000000000000000001
1000000000000000001
1111111111111111111
